11111111111111111111111111111111
10300020000000002000000040000001
10000000000110200000002000000301
10211001130114000110011001100001
10000001100000001100000001111021
12000000000000011100000001111001
10011000000000000000112001100005
10011001100110204000110000000001
10000000000000111100112000000001
00000020000000003000000001100001
00211001100110011000000001111021
10011001100110211000000001111001
10000000000004000001102040000301
10300002000000000001100000000001
11111111111111111111111111111111